Keyword	Exon (donor splice site)-Exon (acceptor splice site)	Strand
CCCAGCCCAGGTGAGGCACA	Exon 4UP/Exon 4-Intron 4_5	Sense
CCCAGCCCAGAATTACAGGG	Exon 4UP/Exon 4-Exon 5/Exon 5EXT/Exon 5a/Exon 5b/Exon 5c	Sense
CCCAGCCCAGCTGGCCTCGG	Exon 4UP/Exon 4-Exon 6b/Exon 6b2/Exon 6c/Exon 6d/Exon 6/Exon 6EXT	Sense
CCCAGCCCAGGAGGGCATCC	Exon 4UP/Exon 4-Exon 7tr/Exon 7	Sense
CCCAGCCCAGAAAAAAAAAA	Exon 4UP/Exon 4-poly(A)	Sense
CCCAGCCCAGCCCATGGTCC	Exon 4UP/Exon 4-Exon 1	Sense
CCCAGCCCAGAAAGTTGAAC	Exon 4UP/Exon 4-Exon 1c	Sense
CCCAGCCCAGAAAGTTTGTA	Exon 4UP/Exon 4-Exon 1d	Sense
CCCAGCCCAGGTGCCTCCAT	Exon 4UP/Exon 4-Exon 2	Sense
CCCAGCCCAGAAGCCCTGCC	Exon 4UP/Exon 4-Exon 3	Sense
CCCAGCCCAGCCCTGCCCAA	Exon 4UP/Exon 4-Exon 3tr	Sense
CCCAGCCCAGAATTGCGAGA	Exon 4UP/Exon 4-Exon 4UP	Sense
CCCAGCCCAGGCCCAGCTAC	Exon 4UP/Exon 4-Exon 4	Sense
CTGCCTCCAGAATTACAGGG	Intron 4_5-Exon 5/Exon 5EXT/Exon 5a/Exon 5b/Exon 5c	Sense
CTGCCTCCAGCTGGCCTCGG	Intron 4_5-Exon 6b/Exon 6b2/Exon 6c/Exon 6d/Exon 6/Exon 6EXT	Sense
CTGCCTCCAGGAGGGCATCC	Intron 4_5-Exon 7tr/Exon 7	Sense
CTGCCTCCAGAAAAAAAAAA	Intron 4_5-poly(A)	Sense
CTGCCTCCAGCCCATGGTCC	Intron 4_5-Exon 1	Sense
CTGCCTCCAGAAAGTTGAAC	Intron 4_5-Exon 1c	Sense
CTGCCTCCAGAAAGTTTGTA	Intron 4_5-Exon 1d	Sense
CTGCCTCCAGGTGCCTCCAT	Intron 4_5-Exon 2	Sense
CTGCCTCCAGAAGCCCTGCC	Intron 4_5-Exon 3	Sense
CTGCCTCCAGCCCTGCCCAA	Intron 4_5-Exon 3tr	Sense
CTGCCTCCAGAATTGCGAGA	Intron 4_5-Exon 4UP	Sense
CTGCCTCCAGGCCCAGCTAC	Intron 4_5-Exon 4	Sense
TAACCAGAAGCTGGCCTCGG	Exon 5-Exon 6b/Exon 6b2/Exon 6c/Exon 6d/Exon 6/Exon 6EXT	Sense
TAACCAGAAGGAGGGCATCC	Exon 5-Exon 7tr/Exon 7	Sense
TAACCAGAAGAAAAAAAAAA	Exon 5-poly(A)	Sense
TAACCAGAAGCCCATGGTCC	Exon 5-Exon 1	Sense
TAACCAGAAGAAAGTTGAAC	Exon 5-Exon 1c	Sense
TAACCAGAAGAAAGTTTGTA	Exon 5-Exon 1d	Sense
TAACCAGAAGGTGCCTCCAT	Exon 5-Exon 2	Sense
TAACCAGAAGAAGCCCTGCC	Exon 5-Exon 3	Sense
TAACCAGAAGCCCTGCCCAA	Exon 5-Exon 3tr	Sense
TAACCAGAAGAATTGCGAGA	Exon 5-Exon 4UP	Sense
TAACCAGAAGGCCCAGCTAC	Exon 5-Exon 4	Sense
TTGCGGAATGCTGGCCTCGG	Exon 5EXT-Exon 6b/Exon 6b2/Exon 6c/Exon 6d/Exon 6/Exon 6EXT	Sense
TTGCGGAATGGAGGGCATCC	Exon 5EXT-Exon 7tr/Exon 7	Sense
TTGCGGAATGAAAAAAAAAA	Exon 5EXT-poly(A)	Sense
TTGCGGAATGCCCATGGTCC	Exon 5EXT-Exon 1	Sense
TTGCGGAATGAAAGTTGAAC	Exon 5EXT-Exon 1c	Sense
TTGCGGAATGAAAGTTTGTA	Exon 5EXT-Exon 1d	Sense
TTGCGGAATGGTGCCTCCAT	Exon 5EXT-Exon 2	Sense
TTGCGGAATGAAGCCCTGCC	Exon 5EXT-Exon 3	Sense
TTGCGGAATGCCCTGCCCAA	Exon 5EXT-Exon 3tr	Sense
TTGCGGAATGAATTGCGAGA	Exon 5EXT-Exon 4UP	Sense
TTGCGGAATGGCCCAGCTAC	Exon 5EXT-Exon 4	Sense
AATGAAGGGTCTGGCCTCGG	Exon 5a-Exon 6b/Exon 6b2/Exon 6c/Exon 6d/Exon 6/Exon 6EXT	Sense
AATGAAGGGTGAGGGCATCC	Exon 5a-Exon 7tr/Exon 7	Sense
AATGAAGGGTAAAAAAAAAA	Exon 5a-poly(A)	Sense
AATGAAGGGTCCCATGGTCC	Exon 5a-Exon 1	Sense
AATGAAGGGTAAAGTTGAAC	Exon 5a-Exon 1c	Sense
AATGAAGGGTAAAGTTTGTA	Exon 5a-Exon 1d	Sense
AATGAAGGGTGTGCCTCCAT	Exon 5a-Exon 2	Sense
AATGAAGGGTAAGCCCTGCC	Exon 5a-Exon 3	Sense
AATGAAGGGTCCCTGCCCAA	Exon 5a-Exon 3tr	Sense
AATGAAGGGTAATTGCGAGA	Exon 5a-Exon 4UP	Sense
AATGAAGGGTGCCCAGCTAC	Exon 5a-Exon 4	Sense
GTGGCTCACGCTGGCCTCGG	Exon 5b-Exon 6b/Exon 6b2/Exon 6c/Exon 6d/Exon 6/Exon 6EXT	Sense
GTGGCTCACGGAGGGCATCC	Exon 5b-Exon 7tr/Exon 7	Sense
GTGGCTCACGAAAAAAAAAA	Exon 5b-poly(A)	Sense
GTGGCTCACGCCCATGGTCC	Exon 5b-Exon 1	Sense
GTGGCTCACGAAAGTTGAAC	Exon 5b-Exon 1c	Sense
GTGGCTCACGAAAGTTTGTA	Exon 5b-Exon 1d	Sense
GTGGCTCACGGTGCCTCCAT	Exon 5b-Exon 2	Sense
GTGGCTCACGAAGCCCTGCC	Exon 5b-Exon 3	Sense
GTGGCTCACGCCCTGCCCAA	Exon 5b-Exon 3tr	Sense
GTGGCTCACGAATTGCGAGA	Exon 5b-Exon 4UP	Sense
GTGGCTCACGGCCCAGCTAC	Exon 5b-Exon 4	Sense
CAGGGGTATGCTGGCCTCGG	Exon 5c-Exon 6b/Exon 6b2/Exon 6c/Exon 6d/Exon 6/Exon 6EXT	Sense
CAGGGGTATGGAGGGCATCC	Exon 5c-Exon 7tr/Exon 7	Sense
CAGGGGTATGAAAAAAAAAA	Exon 5c-poly(A)	Sense
CAGGGGTATGCCCATGGTCC	Exon 5c-Exon 1	Sense
CAGGGGTATGAAAGTTGAAC	Exon 5c-Exon 1c	Sense
CAGGGGTATGAAAGTTTGTA	Exon 5c-Exon 1d	Sense
CAGGGGTATGGTGCCTCCAT	Exon 5c-Exon 2	Sense
CAGGGGTATGAAGCCCTGCC	Exon 5c-Exon 3	Sense
CAGGGGTATGCCCTGCCCAA	Exon 5c-Exon 3tr	Sense
CAGGGGTATGAATTGCGAGA	Exon 5c-Exon 4UP	Sense
CAGGGGTATGGCCCAGCTAC	Exon 5c-Exon 4	Sense
AAGCCGAGCAGAGGGCATCC	Exon 6b-Exon 7tr/Exon 7	Sense
AAGCCGAGCAAAAAAAAAAA	Exon 6b-poly(A)	Sense
AAGCCGAGCACCCATGGTCC	Exon 6b-Exon 1	Sense
AAGCCGAGCAAAAGTTGAAC	Exon 6b-Exon 1c	Sense
AAGCCGAGCAAAAGTTTGTA	Exon 6b-Exon 1d	Sense
AAGCCGAGCAGTGCCTCCAT	Exon 6b-Exon 2	Sense
AAGCCGAGCAAAGCCCTGCC	Exon 6b-Exon 3	Sense
AAGCCGAGCACCCTGCCCAA	Exon 6b-Exon 3tr	Sense
AAGCCGAGCAAATTGCGAGA	Exon 6b-Exon 4UP	Sense
AAGCCGAGCAGCCCAGCTAC	Exon 6b-Exon 4	Sense
GCATGCCCCGGAGGGCATCC	Exon 6b2-Exon 7tr/Exon 7	Sense
GCATGCCCCGAAAAAAAAAA	Exon 6b2-poly(A)	Sense
GCATGCCCCGCCCATGGTCC	Exon 6b2-Exon 1	Sense
GCATGCCCCGAAAGTTGAAC	Exon 6b2-Exon 1c	Sense
GCATGCCCCGAAAGTTTGTA	Exon 6b2-Exon 1d	Sense
GCATGCCCCGGTGCCTCCAT	Exon 6b2-Exon 2	Sense
GCATGCCCCGAAGCCCTGCC	Exon 6b2-Exon 3	Sense
GCATGCCCCGCCCTGCCCAA	Exon 6b2-Exon 3tr	Sense
GCATGCCCCGAATTGCGAGA	Exon 6b2-Exon 4UP	Sense
GCATGCCCCGGCCCAGCTAC	Exon 6b2-Exon 4	Sense
CCGGAGCCCCGAGGGCATCC	Exon 6c-Exon 7tr/Exon 7	Sense
CCGGAGCCCCAAAAAAAAAA	Exon 6c-poly(A)	Sense
CCGGAGCCCCCCCATGGTCC	Exon 6c-Exon 1	Sense
CCGGAGCCCCAAAGTTGAAC	Exon 6c-Exon 1c	Sense
CCGGAGCCCCAAAGTTTGTA	Exon 6c-Exon 1d	Sense
CCGGAGCCCCGTGCCTCCAT	Exon 6c-Exon 2	Sense
CCGGAGCCCCAAGCCCTGCC	Exon 6c-Exon 3	Sense
CCGGAGCCCCCCCTGCCCAA	Exon 6c-Exon 3tr	Sense
CCGGAGCCCCAATTGCGAGA	Exon 6c-Exon 4UP	Sense
CCGGAGCCCCGCCCAGCTAC	Exon 6c-Exon 4	Sense
GGGGCACCCTGAGGGCATCC	Exon 6d-Exon 7tr/Exon 7	Sense
GGGGCACCCTAAAAAAAAAA	Exon 6d-poly(A)	Sense
GGGGCACCCTCCCATGGTCC	Exon 6d-Exon 1	Sense
GGGGCACCCTAAAGTTGAAC	Exon 6d-Exon 1c	Sense
GGGGCACCCTAAAGTTTGTA	Exon 6d-Exon 1d	Sense
GGGGCACCCTGTGCCTCCAT	Exon 6d-Exon 2	Sense
GGGGCACCCTAAGCCCTGCC	Exon 6d-Exon 3	Sense
GGGGCACCCTCCCTGCCCAA	Exon 6d-Exon 3tr	Sense
GGGGCACCCTAATTGCGAGA	Exon 6d-Exon 4UP	Sense
GGGGCACCCTGCCCAGCTAC	Exon 6d-Exon 4	Sense
CGGGGGCTGGGAGGGCATCC	Exon 6-Exon 7tr/Exon 7	Sense
CGGGGGCTGGAAAAAAAAAA	Exon 6-poly(A)	Sense
CGGGGGCTGGCCCATGGTCC	Exon 6-Exon 1	Sense
CGGGGGCTGGAAAGTTGAAC	Exon 6-Exon 1c	Sense
CGGGGGCTGGAAAGTTTGTA	Exon 6-Exon 1d	Sense
CGGGGGCTGGGTGCCTCCAT	Exon 6-Exon 2	Sense
CGGGGGCTGGAAGCCCTGCC	Exon 6-Exon 3	Sense
CGGGGGCTGGCCCTGCCCAA	Exon 6-Exon 3tr	Sense
CGGGGGCTGGAATTGCGAGA	Exon 6-Exon 4UP	Sense
CGGGGGCTGGGCCCAGCTAC	Exon 6-Exon 4	Sense
GTGTCTACTAGAGGGCATCC	Exon 6EXT-Exon 7tr/Exon 7	Sense
GTGTCTACTAAAAAAAAAAA	Exon 6EXT-poly(A)	Sense
GTGTCTACTACCCATGGTCC	Exon 6EXT-Exon 1	Sense
GTGTCTACTAAAAGTTGAAC	Exon 6EXT-Exon 1c	Sense
GTGTCTACTAAAAGTTTGTA	Exon 6EXT-Exon 1d	Sense
GTGTCTACTAGTGCCTCCAT	Exon 6EXT-Exon 2	Sense
GTGTCTACTAAAGCCCTGCC	Exon 6EXT-Exon 3	Sense
GTGTCTACTACCCTGCCCAA	Exon 6EXT-Exon 3tr	Sense
GTGTCTACTAAATTGCGAGA	Exon 6EXT-Exon 4UP	Sense
GTGTCTACTAGCCCAGCTAC	Exon 6EXT-Exon 4	Sense
TGGTTGCCCTAAAAAAAAAA	Exon 7tr-poly(A)	Sense
TGGTTGCCCTCCCATGGTCC	Exon 7tr-Exon 1	Sense
TGGTTGCCCTAAAGTTGAAC	Exon 7tr-Exon 1c	Sense
TGGTTGCCCTAAAGTTTGTA	Exon 7tr-Exon 1d	Sense
TGGTTGCCCTGTGCCTCCAT	Exon 7tr-Exon 2	Sense
TGGTTGCCCTAAGCCCTGCC	Exon 7tr-Exon 3	Sense
TGGTTGCCCTCCCTGCCCAA	Exon 7tr-Exon 3tr	Sense
TGGTTGCCCTAATTGCGAGA	Exon 7tr-Exon 4UP	Sense
TGGTTGCCCTGCCCAGCTAC	Exon 7tr-Exon 4	Sense
TTACAAAGTAAAAAAAAAAA	Exon 7-poly(A)	Sense
TTACAAAGTACCCATGGTCC	Exon 7-Exon 1	Sense
TTACAAAGTAAAAGTTGAAC	Exon 7-Exon 1c	Sense
TTACAAAGTAAAAGTTTGTA	Exon 7-Exon 1d	Sense
TTACAAAGTAGTGCCTCCAT	Exon 7-Exon 2	Sense
TTACAAAGTAAAGCCCTGCC	Exon 7-Exon 3	Sense
TTACAAAGTACCCTGCCCAA	Exon 7-Exon 3tr	Sense
TTACAAAGTAAATTGCGAGA	Exon 7-Exon 4UP	Sense
TTACAAAGTAGCCCAGCTAC	Exon 7-Exon 4	Sense
AAAAAAAAAACCCATGGTCC	poly(A)-Exon 1	Sense
AAAAAAAAAAAAAGTTGAAC	poly(A)-Exon 1c	Sense
AAAAAAAAAAAAAGTTTGTA	poly(A)-Exon 1d	Sense
AAAAAAAAAAGTGCCTCCAT	poly(A)-Exon 2	Sense
AAAAAAAAAAAAGCCCTGCC	poly(A)-Exon 3	Sense
AAAAAAAAAACCCTGCCCAA	poly(A)-Exon 3tr	Sense
AAAAAAAAAAAATTGCGAGA	poly(A)-Exon 4UP	Sense
AAAAAAAAAAGCCCAGCTAC	poly(A)-Exon 4	Sense
CCCGGACCAGGTGCCTCCAT	Exon 1/Exon 1c/Exon 1d-Exon 2	Sense
CCCGGACCAGAAGCCCTGCC	Exon 1/Exon 1c/Exon 1d-Exon 3	Sense
CCCGGACCAGCCCTGCCCAA	Exon 1/Exon 1c/Exon 1d-Exon 3tr	Sense
CCCGGACCAGAATTGCGAGA	Exon 1/Exon 1c/Exon 1d-Exon 4UP	Sense
CCCGGACCAGGCCCAGCTAC	Exon 1/Exon 1c/Exon 1d-Exon 4	Sense
CTCCACCTAGAAGCCCTGCC	Exon 2-Exon 3	Sense
CTCCACCTAGCCCTGCCCAA	Exon 2-Exon 3tr	Sense
CTCCACCTAGAATTGCGAGA	Exon 2-Exon 4UP	Sense
CTCCACCTAGGCCCAGCTAC	Exon 2-Exon 4	Sense
TTAGAGCCTGAATTGCGAGA	Exon 3/Exon 3tr-Exon 4UP	Sense
TTAGAGCCTGGCCCAGCTAC	Exon 3/Exon 3tr-Exon 4	Sense
TGTGCCTCACCTGGGCTGGG	Exon 4UP/Exon 4-Intron 4_5	Antisense
CCCTGTAATTCTGGGCTGGG	Exon 4UP/Exon 4-Exon 5/Exon 5EXT/Exon 5a/Exon 5b/Exon 5c	Antisense
CCGAGGCCAGCTGGGCTGGG	Exon 4UP/Exon 4-Exon 6b/Exon 6b2/Exon 6c/Exon 6d/Exon 6/Exon 6EXT	Antisense
GGATGCCCTCCTGGGCTGGG	Exon 4UP/Exon 4-Exon 7tr/Exon 7	Antisense
TTTTTTTTTTCTGGGCTGGG	Exon 4UP/Exon 4-poly(A)	Antisense
GGACCATGGGCTGGGCTGGG	Exon 4UP/Exon 4-Exon 1	Antisense
GTTCAACTTTCTGGGCTGGG	Exon 4UP/Exon 4-Exon 1c	Antisense
TACAAACTTTCTGGGCTGGG	Exon 4UP/Exon 4-Exon 1d	Antisense
ATGGAGGCACCTGGGCTGGG	Exon 4UP/Exon 4-Exon 2	Antisense
GGCAGGGCTTCTGGGCTGGG	Exon 4UP/Exon 4-Exon 3	Antisense
TTGGGCAGGGCTGGGCTGGG	Exon 4UP/Exon 4-Exon 3tr	Antisense
TCTCGCAATTCTGGGCTGGG	Exon 4UP/Exon 4-Exon 4UP	Antisense
GTAGCTGGGCCTGGGCTGGG	Exon 4UP/Exon 4-Exon 4	Antisense
CCCTGTAATTCTGGAGGCAG	Intron 4_5-Exon 5/Exon 5EXT/Exon 5a/Exon 5b/Exon 5c	Antisense
CCGAGGCCAGCTGGAGGCAG	Intron 4_5-Exon 6b/Exon 6b2/Exon 6c/Exon 6d/Exon 6/Exon 6EXT	Antisense
GGATGCCCTCCTGGAGGCAG	Intron 4_5-Exon 7tr/Exon 7	Antisense
TTTTTTTTTTCTGGAGGCAG	Intron 4_5-poly(A)	Antisense
GGACCATGGGCTGGAGGCAG	Intron 4_5-Exon 1	Antisense
GTTCAACTTTCTGGAGGCAG	Intron 4_5-Exon 1c	Antisense
TACAAACTTTCTGGAGGCAG	Intron 4_5-Exon 1d	Antisense
ATGGAGGCACCTGGAGGCAG	Intron 4_5-Exon 2	Antisense
GGCAGGGCTTCTGGAGGCAG	Intron 4_5-Exon 3	Antisense
TTGGGCAGGGCTGGAGGCAG	Intron 4_5-Exon 3tr	Antisense
TCTCGCAATTCTGGAGGCAG	Intron 4_5-Exon 4UP	Antisense
GTAGCTGGGCCTGGAGGCAG	Intron 4_5-Exon 4	Antisense
CCGAGGCCAGCTTCTGGTTA	Exon 5-Exon 6b/Exon 6b2/Exon 6c/Exon 6d/Exon 6/Exon 6EXT	Antisense
GGATGCCCTCCTTCTGGTTA	Exon 5-Exon 7tr/Exon 7	Antisense
TTTTTTTTTTCTTCTGGTTA	Exon 5-poly(A)	Antisense
GGACCATGGGCTTCTGGTTA	Exon 5-Exon 1	Antisense
GTTCAACTTTCTTCTGGTTA	Exon 5-Exon 1c	Antisense
TACAAACTTTCTTCTGGTTA	Exon 5-Exon 1d	Antisense
ATGGAGGCACCTTCTGGTTA	Exon 5-Exon 2	Antisense
GGCAGGGCTTCTTCTGGTTA	Exon 5-Exon 3	Antisense
TTGGGCAGGGCTTCTGGTTA	Exon 5-Exon 3tr	Antisense
TCTCGCAATTCTTCTGGTTA	Exon 5-Exon 4UP	Antisense
GTAGCTGGGCCTTCTGGTTA	Exon 5-Exon 4	Antisense
CCGAGGCCAGCATTCCGCAA	Exon 5EXT-Exon 6b/Exon 6b2/Exon 6c/Exon 6d/Exon 6/Exon 6EXT	Antisense
GGATGCCCTCCATTCCGCAA	Exon 5EXT-Exon 7tr/Exon 7	Antisense
TTTTTTTTTTCATTCCGCAA	Exon 5EXT-poly(A)	Antisense
GGACCATGGGCATTCCGCAA	Exon 5EXT-Exon 1	Antisense
GTTCAACTTTCATTCCGCAA	Exon 5EXT-Exon 1c	Antisense
TACAAACTTTCATTCCGCAA	Exon 5EXT-Exon 1d	Antisense
ATGGAGGCACCATTCCGCAA	Exon 5EXT-Exon 2	Antisense
GGCAGGGCTTCATTCCGCAA	Exon 5EXT-Exon 3	Antisense
TTGGGCAGGGCATTCCGCAA	Exon 5EXT-Exon 3tr	Antisense
TCTCGCAATTCATTCCGCAA	Exon 5EXT-Exon 4UP	Antisense
GTAGCTGGGCCATTCCGCAA	Exon 5EXT-Exon 4	Antisense
CCGAGGCCAGACCCTTCATT	Exon 5a-Exon 6b/Exon 6b2/Exon 6c/Exon 6d/Exon 6/Exon 6EXT	Antisense
GGATGCCCTCACCCTTCATT	Exon 5a-Exon 7tr/Exon 7	Antisense
TTTTTTTTTTACCCTTCATT	Exon 5a-poly(A)	Antisense
GGACCATGGGACCCTTCATT	Exon 5a-Exon 1	Antisense
GTTCAACTTTACCCTTCATT	Exon 5a-Exon 1c	Antisense
TACAAACTTTACCCTTCATT	Exon 5a-Exon 1d	Antisense
ATGGAGGCACACCCTTCATT	Exon 5a-Exon 2	Antisense
GGCAGGGCTTACCCTTCATT	Exon 5a-Exon 3	Antisense
TTGGGCAGGGACCCTTCATT	Exon 5a-Exon 3tr	Antisense
TCTCGCAATTACCCTTCATT	Exon 5a-Exon 4UP	Antisense
GTAGCTGGGCACCCTTCATT	Exon 5a-Exon 4	Antisense
CCGAGGCCAGCGTGAGCCAC	Exon 5b-Exon 6b/Exon 6b2/Exon 6c/Exon 6d/Exon 6/Exon 6EXT	Antisense
GGATGCCCTCCGTGAGCCAC	Exon 5b-Exon 7tr/Exon 7	Antisense
TTTTTTTTTTCGTGAGCCAC	Exon 5b-poly(A)	Antisense
GGACCATGGGCGTGAGCCAC	Exon 5b-Exon 1	Antisense
GTTCAACTTTCGTGAGCCAC	Exon 5b-Exon 1c	Antisense
TACAAACTTTCGTGAGCCAC	Exon 5b-Exon 1d	Antisense
ATGGAGGCACCGTGAGCCAC	Exon 5b-Exon 2	Antisense
GGCAGGGCTTCGTGAGCCAC	Exon 5b-Exon 3	Antisense
TTGGGCAGGGCGTGAGCCAC	Exon 5b-Exon 3tr	Antisense
TCTCGCAATTCGTGAGCCAC	Exon 5b-Exon 4UP	Antisense
GTAGCTGGGCCGTGAGCCAC	Exon 5b-Exon 4	Antisense
CCGAGGCCAGCATACCCCTG	Exon 5c-Exon 6b/Exon 6b2/Exon 6c/Exon 6d/Exon 6/Exon 6EXT	Antisense
GGATGCCCTCCATACCCCTG	Exon 5c-Exon 7tr/Exon 7	Antisense
TTTTTTTTTTCATACCCCTG	Exon 5c-poly(A)	Antisense
GGACCATGGGCATACCCCTG	Exon 5c-Exon 1	Antisense
GTTCAACTTTCATACCCCTG	Exon 5c-Exon 1c	Antisense
TACAAACTTTCATACCCCTG	Exon 5c-Exon 1d	Antisense
ATGGAGGCACCATACCCCTG	Exon 5c-Exon 2	Antisense
GGCAGGGCTTCATACCCCTG	Exon 5c-Exon 3	Antisense
TTGGGCAGGGCATACCCCTG	Exon 5c-Exon 3tr	Antisense
TCTCGCAATTCATACCCCTG	Exon 5c-Exon 4UP	Antisense
GTAGCTGGGCCATACCCCTG	Exon 5c-Exon 4	Antisense
GGATGCCCTCTGCTCGGCTT	Exon 6b-Exon 7tr/Exon 7	Antisense
TTTTTTTTTTTGCTCGGCTT	Exon 6b-poly(A)	Antisense
GGACCATGGGTGCTCGGCTT	Exon 6b-Exon 1	Antisense
GTTCAACTTTTGCTCGGCTT	Exon 6b-Exon 1c	Antisense
TACAAACTTTTGCTCGGCTT	Exon 6b-Exon 1d	Antisense
ATGGAGGCACTGCTCGGCTT	Exon 6b-Exon 2	Antisense
GGCAGGGCTTTGCTCGGCTT	Exon 6b-Exon 3	Antisense
TTGGGCAGGGTGCTCGGCTT	Exon 6b-Exon 3tr	Antisense
TCTCGCAATTTGCTCGGCTT	Exon 6b-Exon 4UP	Antisense
GTAGCTGGGCTGCTCGGCTT	Exon 6b-Exon 4	Antisense
GGATGCCCTCCGGGGCATGC	Exon 6b2-Exon 7tr/Exon 7	Antisense
TTTTTTTTTTCGGGGCATGC	Exon 6b2-poly(A)	Antisense
GGACCATGGGCGGGGCATGC	Exon 6b2-Exon 1	Antisense
GTTCAACTTTCGGGGCATGC	Exon 6b2-Exon 1c	Antisense
TACAAACTTTCGGGGCATGC	Exon 6b2-Exon 1d	Antisense
ATGGAGGCACCGGGGCATGC	Exon 6b2-Exon 2	Antisense
GGCAGGGCTTCGGGGCATGC	Exon 6b2-Exon 3	Antisense
TTGGGCAGGGCGGGGCATGC	Exon 6b2-Exon 3tr	Antisense
TCTCGCAATTCGGGGCATGC	Exon 6b2-Exon 4UP	Antisense
GTAGCTGGGCCGGGGCATGC	Exon 6b2-Exon 4	Antisense
GGATGCCCTCGGGGCTCCGG	Exon 6c-Exon 7tr/Exon 7	Antisense
TTTTTTTTTTGGGGCTCCGG	Exon 6c-poly(A)	Antisense
GGACCATGGGGGGGCTCCGG	Exon 6c-Exon 1	Antisense
GTTCAACTTTGGGGCTCCGG	Exon 6c-Exon 1c	Antisense
TACAAACTTTGGGGCTCCGG	Exon 6c-Exon 1d	Antisense
ATGGAGGCACGGGGCTCCGG	Exon 6c-Exon 2	Antisense
GGCAGGGCTTGGGGCTCCGG	Exon 6c-Exon 3	Antisense
TTGGGCAGGGGGGGCTCCGG	Exon 6c-Exon 3tr	Antisense
TCTCGCAATTGGGGCTCCGG	Exon 6c-Exon 4UP	Antisense
GTAGCTGGGCGGGGCTCCGG	Exon 6c-Exon 4	Antisense
GGATGCCCTCAGGGTGCCCC	Exon 6d-Exon 7tr/Exon 7	Antisense
TTTTTTTTTTAGGGTGCCCC	Exon 6d-poly(A)	Antisense
GGACCATGGGAGGGTGCCCC	Exon 6d-Exon 1	Antisense
GTTCAACTTTAGGGTGCCCC	Exon 6d-Exon 1c	Antisense
TACAAACTTTAGGGTGCCCC	Exon 6d-Exon 1d	Antisense
ATGGAGGCACAGGGTGCCCC	Exon 6d-Exon 2	Antisense
GGCAGGGCTTAGGGTGCCCC	Exon 6d-Exon 3	Antisense
TTGGGCAGGGAGGGTGCCCC	Exon 6d-Exon 3tr	Antisense
TCTCGCAATTAGGGTGCCCC	Exon 6d-Exon 4UP	Antisense
GTAGCTGGGCAGGGTGCCCC	Exon 6d-Exon 4	Antisense
GGATGCCCTCCCAGCCCCCG	Exon 6-Exon 7tr/Exon 7	Antisense
TTTTTTTTTTCCAGCCCCCG	Exon 6-poly(A)	Antisense
GGACCATGGGCCAGCCCCCG	Exon 6-Exon 1	Antisense
GTTCAACTTTCCAGCCCCCG	Exon 6-Exon 1c	Antisense
TACAAACTTTCCAGCCCCCG	Exon 6-Exon 1d	Antisense
ATGGAGGCACCCAGCCCCCG	Exon 6-Exon 2	Antisense
GGCAGGGCTTCCAGCCCCCG	Exon 6-Exon 3	Antisense
TTGGGCAGGGCCAGCCCCCG	Exon 6-Exon 3tr	Antisense
TCTCGCAATTCCAGCCCCCG	Exon 6-Exon 4UP	Antisense
GTAGCTGGGCCCAGCCCCCG	Exon 6-Exon 4	Antisense
GGATGCCCTCTAGTAGACAC	Exon 6EXT-Exon 7tr/Exon 7	Antisense
TTTTTTTTTTTAGTAGACAC	Exon 6EXT-poly(A)	Antisense
GGACCATGGGTAGTAGACAC	Exon 6EXT-Exon 1	Antisense
GTTCAACTTTTAGTAGACAC	Exon 6EXT-Exon 1c	Antisense
TACAAACTTTTAGTAGACAC	Exon 6EXT-Exon 1d	Antisense
ATGGAGGCACTAGTAGACAC	Exon 6EXT-Exon 2	Antisense
GGCAGGGCTTTAGTAGACAC	Exon 6EXT-Exon 3	Antisense
TTGGGCAGGGTAGTAGACAC	Exon 6EXT-Exon 3tr	Antisense
TCTCGCAATTTAGTAGACAC	Exon 6EXT-Exon 4UP	Antisense
GTAGCTGGGCTAGTAGACAC	Exon 6EXT-Exon 4	Antisense
TTTTTTTTTTAGGGCAACCA	Exon 7tr-poly(A)	Antisense
GGACCATGGGAGGGCAACCA	Exon 7tr-Exon 1	Antisense
GTTCAACTTTAGGGCAACCA	Exon 7tr-Exon 1c	Antisense
TACAAACTTTAGGGCAACCA	Exon 7tr-Exon 1d	Antisense
ATGGAGGCACAGGGCAACCA	Exon 7tr-Exon 2	Antisense
GGCAGGGCTTAGGGCAACCA	Exon 7tr-Exon 3	Antisense
TTGGGCAGGGAGGGCAACCA	Exon 7tr-Exon 3tr	Antisense
TCTCGCAATTAGGGCAACCA	Exon 7tr-Exon 4UP	Antisense
GTAGCTGGGCAGGGCAACCA	Exon 7tr-Exon 4	Antisense
TTTTTTTTTTTACTTTGTAA	Exon 7-poly(A)	Antisense
GGACCATGGGTACTTTGTAA	Exon 7-Exon 1	Antisense
GTTCAACTTTTACTTTGTAA	Exon 7-Exon 1c	Antisense
TACAAACTTTTACTTTGTAA	Exon 7-Exon 1d	Antisense
ATGGAGGCACTACTTTGTAA	Exon 7-Exon 2	Antisense
GGCAGGGCTTTACTTTGTAA	Exon 7-Exon 3	Antisense
TTGGGCAGGGTACTTTGTAA	Exon 7-Exon 3tr	Antisense
TCTCGCAATTTACTTTGTAA	Exon 7-Exon 4UP	Antisense
GTAGCTGGGCTACTTTGTAA	Exon 7-Exon 4	Antisense
GGACCATGGGTTTTTTTTTT	poly(A)-Exon 1	Antisense
GTTCAACTTTTTTTTTTTTT	poly(A)-Exon 1c	Antisense
TACAAACTTTTTTTTTTTTT	poly(A)-Exon 1d	Antisense
ATGGAGGCACTTTTTTTTTT	poly(A)-Exon 2	Antisense
GGCAGGGCTTTTTTTTTTTT	poly(A)-Exon 3	Antisense
TTGGGCAGGGTTTTTTTTTT	poly(A)-Exon 3tr	Antisense
TCTCGCAATTTTTTTTTTTT	poly(A)-Exon 4UP	Antisense
GTAGCTGGGCTTTTTTTTTT	poly(A)-Exon 4	Antisense
ATGGAGGCACCTGGTCCGGG	Exon 1/Exon 1c/Exon 1d-Exon 2	Antisense
GGCAGGGCTTCTGGTCCGGG	Exon 1/Exon 1c/Exon 1d-Exon 3	Antisense
TTGGGCAGGGCTGGTCCGGG	Exon 1/Exon 1c/Exon 1d-Exon 3tr	Antisense
TCTCGCAATTCTGGTCCGGG	Exon 1/Exon 1c/Exon 1d-Exon 4UP	Antisense
GTAGCTGGGCCTGGTCCGGG	Exon 1/Exon 1c/Exon 1d-Exon 4	Antisense
GGCAGGGCTTCTAGGTGGAG	Exon 2-Exon 3	Antisense
TTGGGCAGGGCTAGGTGGAG	Exon 2-Exon 3tr	Antisense
TCTCGCAATTCTAGGTGGAG	Exon 2-Exon 4UP	Antisense
GTAGCTGGGCCTAGGTGGAG	Exon 2-Exon 4	Antisense
TCTCGCAATTCAGGCTCTAA	Exon 3/Exon 3tr-Exon 4UP	Antisense
GTAGCTGGGCCAGGCTCTAA	Exon 3/Exon 3tr-Exon 4	Antisense
